11111111111111111111
1P0000110000000000E1
10111011101111110111
100010000C0000100011
11101011111011101111
1C00100000100000C001
10111110111011111011
100000C0000000000001
11111111111111111111